11
21
<map>
@@@@@@@@@ @@@@@@@@@@@
@     @ @ @       @ @
@ @ @ @ @   @@@ @ @ @
@@@ @ @ @@@@@ @ @ @ @
@   @   @   @   @ @ @
@ @@@@@@@ @ @@@@@   @
@ @ @     @   @     @
@ @   @  @@ @ @ @@@@@
@ @@@@@@  @ @ @ @   @
@         @@@       @
@@@@@@@@@@@@@@@@@@@@@
</map>
